24x24
000000000000000000000000
000000000000000000000000
011111111110011111111110
010001000010010000100010
010001000010010000100010
011111111111111111111110
010001010000000010100010
011111011110011110111110
000001000010010000100000
111101011111111110101111
000001010001100010100000
111111110011110011111111
000001010000000010100000
111101011111111110101111
000001010000000010100000
011111111110011111111110
010001000010010000100010
011101111111111111101110
000101010000000010101000
011111011110011110111110
010000000010010000000010
011111111111111111111110
000000000000000000000000
000000000000000000000000
(13, 12)
(11, 10);(11, 11);(11, 12);(11, 13)
(9, 0);(9, 1);(9, 2);(9, 3);(9, 20);(9, 21);(9, 22);(9, 23);(13, 0);(13, 1);(13, 2);(13, 3);(13, 20);(13, 21);(13, 22);(13, 23);(10, 11);(10, 12)
