24x24
000000000000000000000000
000000000000000000000000
011111111110011111111110
010001000010010000100010
010001000011110000100010
011111111110011111111110
010001010000000010100010
011111011110011110111110
000101000010010000101000
011101111111111111101110
010001010001100010100010
011111010011110010111110
010001010000000010100010
011101011111111110101110
000101010000000010101000
011111111111111111111110
010001000010010000100010
011101111110011111101110
000101010000000010101000
011111011110011110111110
010000000010010000000010
011111111111111111111110
000000000000000000000000
000000000000000000000000
(13, 12)
(11, 10);(11, 11);(11, 12);(11, 13)
(10, 11);(10, 12)
