7x35
00000000000000000000000000000000000
01111111011111111101111111011111110
01010101010010100001010100010001000
01110110010010101101100110011101110
01000101010010100101010100000100010
11000101111110111111010111111101111
00000000000000000000000000000000000
(3, 17)
(1, 1);(5, 21)
(4, 21);(5, 21)